сссссззззз
зззззссссс
сссссззззз
зззззссссс
сссссззззз
зззззссссс
сссссззззз
зззззссссс

зсзсзсзсзс
сзсзсзсзсз
зсзсзсзсзс
сзсзсзсзсз
зсзсзсзсзс
сзсзсзсзсз
зсзсзсзсзс
сзсзсзсзсз

зввввввввв
зввввввввв
зввввввввв
зсссзссссс
сссссззссс
ззззсссззз
ссзззссзсс
сззззсзззз

зссссззззз
зззззззззз
зссссссссс
сззззззззз
ззззззсззз
ззсзззсззз
всввввввсв
всззсзвввв

зссссссссс
сссссссссс
сссссссссс
сссссссссс
сссссссссс
сссссссссс
сссссссссс
сссссссссс 

ззззввзсзз
зввзззззсз
звввссвввв
звззззззвз
сзссвввссв
ззввззввзз
вссввссссс
взззззсззз


