зссссззззз
зззззззззз
зввввввввв
зззззззззз
сссссссссс
зззззззззз
сссссссссс
зззззззззз

зззззззззз
зззззззззз
зззззззззз
зззвввзззз
сссззззссс
зззззззззз
сссссссссс
зззззззззз

ззззввзззс
зсззззззсз
ззсззззсзз
зззсззсззз
ззззссзззз
ззззссзззз
зззсззсззз
ззсзввзсзз

ззззсззззз
зззсссзззз
ззсссссззз
зсссссссзз
сссссссссс
зззввввззз
зззззззззз
зззззззззз

зззззсзззв
зсзсзввззз
сссвсззсвз
свсвсвсвзз
зззззсзззз
зззззззззз
вввввввввв
ззввззввзз

